フシギダネ,45,49,49,65,65,45,318,くさ,どく
フシギソウ,60,62,63,80,80,60,405,くさ,どく
フシギバナ,80,82,83,100,100,80,525,くさ,どく
メガフシギバナ,80,100,123,122,120,80,625,くさ,どく
ヒトカゲ,39,52,43,60,50,65,309,ほのお,
リザード,58,64,58,80,65,80,405,ほのお,
リザードン,78,84,78,109,85,100,534,ほのお,ひこう
メガリザードンX,78,130,111,130,85,100,634,ほのお,ドラゴン
メガリザードンY,78,104,78,159,115,100,634,ほのお,ひこう
ゼニガメ,44,48,65,50,64,43,314,みず,
カメール,59,63,80,65,80,58,405,みず,
カメックス,79,83,100,85,105,78,530,みず,
メガカメックス,79,103,120,135,115,78,630,みず,
キャタピー,45,30,35,20,20,45,195,むし,
トランセル,50,20,55,25,25,30,205,むし,
バタフリー,60,45,50,90,80,70,395,むし,ひこう
ビードル,40,35,30,20,20,50,195,むし,どく
コクーン,45,25,50,25,25,35,205,むし,どく
スピアー,65,90,40,45,80,75,395,むし,どく
メガスピアー,65,150,40,15,80,145,495,むし,どく
ポッポ,40,45,40,35,35,56,251,ノーマル,ひこう
ピジョン,63,60,55,50,50,71,349,ノーマル,ひこう
ピジョット,83,80,75,70,70,101,479,ノーマル,ひこう
メガピジョット,83,80,80,135,80,121,579,ノーマル,ひこう
コラッタ,30,56,35,25,35,72,253,ノーマル,,FC
コラッタ（アローラ）,30,56,35,25,35,72,253,あく,ノーマル,FC
ラッタ,55,81,60,50,70,97,413,ノーマル,,FC
ラッタ（アローラ）,75,71,70,40,80,77,413,あく,ノーマル,FC
オニスズメ,40,60,30,31,31,70,262,ノーマル,ひこう
オニドリル,65,90,65,61,61,100,442,ノーマル,ひこう
アーボ,35,60,44,40,54,55,288,どく,
アーボック,60,95,69,65,79,80,448,どく,
ピカチュウ,35,55,40,50,50,90,320,でんき,
ライチュウ,60,90,55,90,80,110,485,でんき,FC
ライチュウ（アローラ）,60,85,50,95,85,110,485,でんき,エスパー,FC
サンド,50,75,85,20,30,40,300,じめん,FC
サンド（アローラ）,50,75,90,10,35,40,300,こおり,はがね,FC
サンドパン,75,100,110,45,55,65,450,じめん,FC
サンドパン（アローラ）,75,100,120,25,65,65,450,こおり,はがね,FC
ニドラン（メス）,55,47,52,40,40,41,275,どく,
ニドリーナ,70,62,67,55,55,56,365,どく,
ニドクイン,90,92,87,75,85,76,505,どく,じめん
ニドラン（オス）,46,57,40,40,40,50,273,どく,
ニドリーノ,61,72,57,55,55,65,365,どく,
ニドキング,81,102,77,85,75,85,505,どく,じめん
ピッピ,70,45,48,60,65,35,323,フェアリー,
ピクシー,95,70,73,95,90,60,483,フェアリー,
ロコン,38,41,40,50,65,65,299,ほのお,FC
ロコン（アローラ）,38,41,40,50,65,65,299,こおり,FC
キュウコン,73,76,75,81,100,100,505,ほのお,FC
キュウコン（アローラ）,73,67,75,81,100,109,505,こおり,フェアリー,FC
プリン,115,45,20,45,25,20,270,ノーマル,フェアリー
プクリン,140,70,45,85,50,45,435,ノーマル,フェアリー
ズバット,40,45,35,30,40,55,245,どく,ひこう
ゴルバット,75,80,70,65,75,90,455,どく,ひこう
ナゾノクサ,45,50,55,75,65,30,320,くさ,どく
クサイハナ,60,65,70,85,75,40,395,くさ,どく
ラフレシア,75,80,85,110,90,50,490,くさ,どく
パラス,35,70,55,45,55,25,285,むし,くさ
パラセクト,60,95,80,60,80,30,405,むし,くさ
コンパン,60,55,50,40,55,45,305,むし,どく
モルフォン,70,65,60,90,75,90,450,むし,どく
ディグダ,10,55,25,35,45,95,265,じめん,
ディグダ（アローラ）,10,55,30,35,45,90,265,じめん,はがね,FC
ダグトリオ,35,100,50,50,70,120,425,じめん,
ダグドリオ（アローラ）,35,100,60,50,70,110,425,じめん,はがね
ニャース,40,45,35,40,40,90,290,ノーマル,
ニャース（アローラ）,40,35,35,50,40,90,290,あく,
ペルシアン,65,70,60,65,65,115,440,ノーマル,
ペルシアン（アローラ）,65,60,60,75,65,115,440,あく,
コダック,50,52,48,65,50,55,320,みず,
ゴルダック,80,82,78,95,80,85,500,みず,
マンキー,40,80,35,35,45,70,305,かくとう,
オコリザル,65,105,60,60,70,95,455,かくとう,
ガーディ,55,70,45,70,50,60,350,ほのお,
ウインディ,90,110,80,100,80,95,555,ほのお,
ニョロモ,40,50,40,40,40,90,300,みず,
ニョロゾ,65,65,65,50,50,90,385,みず,
ニョロボン,90,95,95,70,90,70,510,みず,かくとう
ケーシィ,25,20,15,105,55,90,310,エスパー,
ユンゲラー,40,35,30,120,70,105,400,エスパー,
フーディン,55,50,45,135,95,120,500,エスパー,
メガフーディン,55,50,65,175,105,150,600,エスパー,
ワンリキー,70,80,50,35,35,35,305,かくとう,
ゴーリキー,80,100,70,50,60,45,405,かくとう,
カイリキー,90,130,80,65,85,55,505,かくとう,
マダツボミ,50,75,35,70,30,40,300,くさ,どく
ウツドン,65,90,50,85,45,55,390,くさ,どく
ウツボット,80,105,65,100,70,70,490,くさ,どく
メノクラゲ,40,40,35,50,100,70,335,みず,どく
ドククラゲ,80,70,65,80,120,100,515,みず,どく
イシツブテ,40,80,100,30,30,20,300,いわ,じめん
イシツブテ（アローラ）,40,80,100,30,30,20,300,いわ,でんき
ゴローン,55,95,115,45,45,35,390,いわ,じめん
ゴローン（アローラ）,55,95,115,45,45,35,390,いわ,でんき
ゴローニャ,80,120,130,55,65,45,495,いわ,じめん
ゴローニャ（アローラ）,80,120,130,55,65,45,495,いわ,でんき
ポニータ,50,85,55,65,65,90,410,ほのお,
ギャロップ,65,100,70,80,80,105,500,ほのお,
ヤドン,90,65,65,40,40,15,315,みず,エスパー
ヤドラン,95,75,110,100,80,30,490,みず,エスパー
メガヤドラン,95,75,180,130,80,30,590,みず,エスパー
コイル,25,35,70,95,55,45,325,でんき,はがね
レアコイル,50,60,95,120,70,70,465,でんき,はがね
カモネギ,52,90,55,58,62,60,377,ノーマル,ひこう
ドードー,35,85,45,35,35,75,310,ノーマル,ひこう
ドードリオ,60,110,70,60,60,110,470,ノーマル,ひこう
パウワウ,65,45,55,45,70,45,325,みず,
ジュゴン,90,70,80,70,95,70,475,みず,こおり
ベトベター,80,80,50,40,50,25,325,どく,
ベトベター（アローラ）,80,80,50,40,50,25,325,どく,あく
ベトベトン,105,105,75,65,100,50,500,どく,
ベトベトン（アローラ）,105,105,75,65,100,50,500,どく,あく
シェルダー,30,65,100,45,25,40,305,みず,
パルシェン,50,95,180,85,45,70,525,みず,こおり
ゴース,30,35,30,100,35,80,310,ゴースト,どく
ゴースト,45,50,45,115,55,95,405,ゴースト,どく
ゲンガー,60,65,60,130,75,110,500,ゴースト,どく
メガゲンガー,60,65,80,170,95,130,600,ゴースト,どく
イワーク,35,45,160,30,45,70,385,いわ,じめん
スリープ,60,48,45,43,90,42,328,エスパー,
スリーパー　,85,73,70,73,115,67,483,エスパー,
クラブ,30,105,90,25,25,50,325,みず,
キングラー,55,130,115,50,50,75,475,みず,
ビリリダマ,40,30,50,55,55,100,330,でんき,
マルマイン,60,50,70,80,80,150,490,でんき,
タマタマ,60,40,80,60,45,40,325,くさ,エスパー
ナッシー,95,95,85,125,75,55,530,くさ,エスパー
ナッシー（アローラ）,95,105,85,125,75,45,530,くさ,ドラゴン
カラカラ,50,50,95,40,50,35,320,じめん,
ガラガラ,60,80,110,50,80,45,425,じめん,
ガラガラ（アローラ）,60,80,110,50,80,45,425,ほのお,ゴースト
サワムラー,50,120,53,35,110,87,455,かくとう,
エビワラー,50,105,79,35,110,76,455,かくとう,
ベロリンガ,90,55,75,60,75,30,385,ノーマル,
ドガース,40,65,95,60,45,35,340,どく,
マタドガス,65,90,120,85,70,60,490,どく,
サイホーン,80,85,95,30,30,25,345,じめん,いわ
サイドン,105,130,120,45,45,40,485,じめん,いわ
ラッキー,250,5,5,35,105,50,450,ノーマル,
モンジャラ,65,55,115,100,40,60,435,くさ,
ガルーラ,105,95,80,40,80,90,490,ノーマル,
メガガルーラ,105,125,100,60,100,100,590,ノーマル,
タッツー,30,40,70,70,25,60,295,みず,
シードラ,55,65,95,95,45,85,440,みず,
トサキント,45,67,60,35,50,63,320,みず,
アズマオウ,80,92,65,65,80,68,450,みず,
ヒトデマン,30,45,55,70,55,85,340,みず,
スターミー,60,75,85,100,85,115,520,みず,エスパー
バリヤード,40,45,65,100,120,90,460,エスパー,フェアリー
ストライク,70,110,80,55,80,105,500,むし,ひこう
ルージュラ,65,50,35,115,95,95,455,こおり,エスパー
エレブー,65,83,57,95,85,105,490,でんき,
ブーバー,65,95,57,100,85,93,495,ほのお,
カイロス,65,125,100,55,70,85,500,むし,
メガカイロス,65,155,120,65,90,105,600,むし,ひこう
ケンタロス,75,100,95,40,70,110,490,ノーマル,
コイキング,20,10,55,15,20,80,200,みず,
ギャラドス,95,125,79,60,100,81,540,みず,ひこう
メガギャラドス,95,155,109,70,130,81,640,みず,あく
ラプラス,130,85,80,85,95,60,535,みず,こおり
メタモン,48,48,48,48,48,48,288,ノーマル,
イーブイ,55,55,50,45,65,55,325,ノーマル,
シャワーズ,130,65,60,110,95,65,525,みず,
サンダース,65,65,60,110,95,130,525,でんき,
ブースター,65,130,60,95,110,65,525,ほのお,
ポリゴン,65,60,70,85,75,40,395,ノーマル,
オムナイト,35,40,100,90,55,35,355,いわ,みず
オムスター,70,60,125,115,70,55,495,いわ,みず
カブト,30,80,90,55,45,55,355,いわ,みず
カブトプス,60,115,105,65,70,80,495,いわ,みず
プテラ,80,105,65,60,75,130,515,いわ,ひこう
メガプテラ,80,135,85,70,95,150,615,いわ,ひこう
カビゴン,160,110,65,65,110,30,540,ノーマル,
フリーザー,90,85,100,95,125,85,580,こおり,ひこう
サンダー,90,90,85,125,90,100,580,でんき,ひこう
ファイヤー,90,100,90,125,85,90,580,ほのお,ひこう
ミニリュウ,41,64,45,50,50,50,300,ドラゴン,
ハクリュー,61,84,65,70,70,70,420,ドラゴン,
カイリュー,91,134,95,100,100,80,600,ドラゴン,ひこう
ミュウツー,106,110,90,154,90,130,680,エスパー,
メガミュウツーX,106,190,100,154,100,130,780,エスパー,かくとう
メガミュウツーY,106,150,70,194,120,140,780,エスパー,
ミュウ,100,100,100,100,100,100,600,エスパー,
チコリータ,45,49,65,49,65,45,318,くさ,
ベイリーフ,60,62,80,63,80,60,405,くさ,
メガニウム,80,82,100,83,100,80,525,くさ,
ヒノアラシ,39,52,43,60,50,65,309,ほのお,
マグマラシ,58,64,58,80,65,80,405,ほのお,
バクフーン,78,84,78,109,85,100,534,ほのお,
ワニノコ,50,65,64,44,48,43,314,みず,
アリゲイツ,65,80,80,59,63,58,405,みず,
オーダイル,85,105,100,79,83,78,530,みず,
オタチ,35,46,34,35,45,20,215,ノーマル,
オオタチ,85,76,64,45,55,90,415,ノーマル,
ホーホー,60,30,30,36,56,50,262,ノーマル,ひこう
ヨルノズク,100,50,50,86,96,70,452,ノーマル,ひこう
レディバ,40,20,30,40,80,55,265,むし,ひこう
レディアン,55,35,50,55,110,85,390,むし,ひこう
イトマル,40,60,40,40,40,30,250,むし,どく
アリアドス,70,90,70,60,70,40,400,むし,どく
クロバット,85,90,80,70,80,130,535,どく,ひこう
チョンチー,75,38,38,56,56,67,330,みず,でんき
ランターン,125,58,58,76,76,67,460,みず,でんき
ピチュー,20,40,15,35,35,60,205,でんき,
ピィ,50,25,28,45,55,15,218,フェアリー,
ププリン,90,30,15,40,20,15,210,ノーマル,フェアリー
トゲピー,35,20,65,40,65,20,245,フェアリー,
トゲチック,55,40,85,80,105,40,405,フェアリー,ひこう
ネイティ,40,50,45,70,45,70,320,エスパー,ひこう
ネイティオ,65,75,70,95,70,95,470,エスパー,ひこう
メリープ,55,40,40,65,45,35,280,でんき,
モココ,70,55,55,80,60,45,365,でんき,
デンリュウ,90,75,85,115,90,55,510,でんき,
メガデンリュウ,90,95,105,165,110,45,610,でんき,ドラゴン
キレイハナ,75,80,95,90,100,50,490,くさ,
マリル,70,20,50,20,50,40,250,みず,フェアリー
マリルリ,100,50,80,60,80,50,420,みず,フェアリー
ウソッキー,70,100,115,30,65,30,410,いわ,
ニョロトノ,90,75,75,90,100,70,500,みず,
ハネッコ,35,35,40,35,55,50,250,くさ,ひこう
ポポッコ,55,45,50,45,65,80,340,くさ,ひこう
ワタッコ,75,55,70,55,95,110,460,くさ,ひこう
エイパム,55,70,55,40,55,85,360,ノーマル,
ヒマナッツ,30,30,30,30,30,30,180,くさ,
キマワリ,75,75,55,105,85,30,425,くさ,
ヤンヤンマ,65,65,45,75,45,95,390,むし,ひこう
ウパー,55,45,45,25,25,15,210,みず,じめん
ヌオー,95,85,85,65,65,35,430,みず,じめん
エーフィ,65,65,60,130,95,110,525,エスパー,
ブラッキー,95,65,110,60,130,65,525,あく,
ヤミカラス,60,85,42,85,42,91,405,あく,ひこう
ヤドキング,95,75,80,100,110,30,490,みず,エスパー
ムウマ,60,60,60,85,85,85,435,ゴースト,
アンノーン,48,72,48,72,48,48,336,エスパー,
ソーナンス,190,33,58,33,58,33,405,エスパー,
キリンリキ,70,80,65,90,65,85,455,ノーマル,エスパー
クヌギダマ,50,65,90,35,35,15,290,むし,
フォレトス,75,90,140,60,60,40,465,むし,はがね
ノコッチ,100,70,70,65,65,45,415,ノーマル,
グライガー,65,75,105,35,65,85,430,じめん,ひこう
ハガネール,75,85,200,55,65,30,510,はがね,じめん
メガハガネール,75,125,230,55,95,30,610,はがね,じめん
ブルー,60,80,50,40,40,30,300,フェアリー,
グランブル,90,120,75,60,60,45,450,フェアリー,
ハリーセン,65,95,85,55,55,85,440,みず,どく
ハッサム,70,130,100,55,80,65,500,むし,はがね
メガハッサム,70,150,140,65,100,75,600,むし,はがね
ツボツボ,20,10,230,10,230,5,505,むし,いわ
ヘラクロス,80,125,75,40,95,85,500,むし,かくとう
メガヘラクロス,80,185,115,40,105,75,600,むし,かくとう
ニューラ,55,95,55,35,75,115,430,あく,こおり
ヒメグマ,60,80,50,50,50,40,330,ノーマル,
リングマ,90,130,75,75,75,55,500,ノーマル,
マグマッグ,40,40,40,70,40,20,250,ほのお,
マグカルゴ,60,50,120,90,80,30,430,ほのお,いわ
ウリムー,50,50,40,30,30,50,250,こおり,じめん
イノムー,100,100,80,60,60,50,450,こおり,じめん
サニーゴ,65,55,95,65,95,35,410,みず,いわ
テッポウオ,35,65,35,65,35,65,300,みず,
オクタン,75,105,75,105,75,45,480,みず,
デリバード,45,55,45,65,45,75,330,こおり,ひこう
マンタイン,85,40,70,80,140,70,485,みず,ひこう
エアームド,65,80,140,40,70,70,465,はがね,ひこう
デルビル,45,60,30,80,50,65,330,あく,ほのお
ヘルガー,75,90,50,110,80,95,500,あく,ほのお
メガヘルガー,75,90,90,140,90,115,600,あく,ほのお
キングドラ,75,95,95,95,95,85,540,みず,ドラゴン
ゴマゾウ,90,60,60,40,40,40,330,じめん,
ドンファン,90,120,120,60,60,50,500,じめん,
ポリゴン２,85,80,90,105,95,60,515,ノーマル,
オドシシ,73,95,62,85,65,85,465,ノーマル,
ドーブル,55,20,35,20,45,75,250,ノーマル,
バルキー,35,35,35,35,35,35,210,かくとう,
カポエラー,50,95,95,35,110,70,455,かくとう,
ムチュール,45,30,15,85,65,65,305,こおり,エスパー
エレキッド,45,63,37,65,55,95,360,でんき,
ブビィ,45,75,37,70,55,83,365,ほのお,
ミルタンク,95,80,105,40,70,100,490,ノーマル,
ハピナス,255,10,10,75,135,55,540,ノーマル,
ライコウ,90,85,75,115,100,115,580,でんき,
エンテイ,115,115,85,90,75,100,580,ほのお,
スイクン,100,75,115,90,115,85,580,みず,
ヨーギラス,50,64,50,45,50,41,300,いわ,じめん
サナギラス,70,84,70,65,70,51,410,いわ,じめん
バンギラス,100,134,110,95,100,61,600,いわ,あく
メガバンギラス,100,164,150,95,120,71,700,いわ,あく
ルギア,106,90,130,90,154,110,680,エスパー,ひこう
ホウオウ,106,130,90,110,154,90,680,ほのお,ひこう
セレビィ,100,100,100,100,100,100,600,エスパー,むし
キモリ,40,45,35,65,55,70,310,くさ,
ジュプトル,50,65,45,85,65,95,405,くさ,
ジュカイン,70,85,65,105,85,120,530,くさ,
メガジュカイン,70,110,75,145,85,145,630,くさ,ドラゴン
アチャモ,45,60,40,70,50,45,310,ほのお,
ワカシャモ,60,85,60,85,60,55,405,ほのお,かくとう
バシャーモ,80,120,70,110,70,80,530,ほのお,かくとう
メガバシャーモ,80,160,80,130,80,100,630,ほのお,かくとう
ミズゴロウ,50,70,50,50,50,40,310,みず,
ヌマクロー,70,85,70,60,70,50,405,みず,じめん
ラグラージ,100,110,90,85,90,60,535,みず,じめん
メガラグラージ,100,150,110,95,110,70,635,みず,じめん
ポチエナ,35,55,35,30,30,35,220,あく,
グラエナ,70,90,70,60,60,70,420,あく,
ジグザグマ,38,30,41,30,41,60,240,ノーマル,
マッスグマ,78,70,61,50,61,100,420,ノーマル,
ケムッソ,45,45,35,20,30,20,195,むし,
カラサリス,50,35,55,25,25,15,205,むし,
アゲハント,60,70,50,100,50,65,395,むし,ひこう
マユルド,50,35,55,25,25,15,205,むし,
ドクケイル,60,50,70,50,90,65,385,むし,どく
ハスボー,40,30,30,40,50,30,220,みず,むし
ハスブレロ,60,50,50,60,70,50,340,みず,むし
ルンパッパ,80,70,70,90,100,70,480,みず,むし
タネボー,40,40,50,30,30,30,220,くさ,
コノハナ,70,70,40,60,40,60,340,くさ,あく
ダーテング,90,100,60,90,60,80,480,くさ,あく
スバメ,40,55,30,30,30,85,270,ノーマル,ひこう
オオスバメ,60,85,60,75,50,125,455,ノーマル,ひこう
キャモメ,40,30,30,55,30,85,270,みず,ひこう
ペリッパー,60,50,100,95,70,65,440,みず,ひこう
ラルトス,28,25,25,45,35,40,198,エスパー,フェアリー
キルリア,38,35,35,65,55,50,278,エスパー,フェアリー
サーナイト,68,65,65,125,115,80,518,エスパー,フェアリー
メガサーナイト,68,85,65,165,135,100,618,エスパー,フェアリー
アメタマ,40,30,32,50,52,65,269,むし,みず
アメモース,70,60,62,100,82,80,454,むし,ひこう
キノココ,60,40,60,40,60,35,295,くさ,
キノガッサ,60,130,80,60,60,70,460,くさ,かくとう
ナマケロ,60,60,60,35,35,30,280,ノーマル,
ヤルキモノ,80,80,80,55,55,90,440,ノーマル,
ケッキング,150,160,100,95,65,100,670,ノーマル,
ツチニン,31,45,90,30,30,40,266,むし,じめん
テッカニン,61,90,45,50,50,160,456,むし,ひこう
ヌケニン,1,90,45,30,30,40,236,むし,ゴースト
ゴニョニョ,64,51,23,51,23,28,240,ノーマル,
ドゴーム,84,71,43,71,43,48,360,ノーマル,
バクオング,104,91,63,91,73,68,490,ノーマル,
マクノシタ,72,60,30,20,30,25,237,かくとう,
ハリテヤマ,144,120,60,40,60,50,474,かくとう,
ルリリ,50,20,40,20,40,20,190,ノーマル,フェアリー
ノズパス,30,45,135,45,90,30,375,いわ,
エネコ,50,45,45,35,35,50,260,ノーマル,
エネコロロ,70,65,65,55,55,90,400,ノーマル,
ヤミラミ,50,75,75,65,65,50,380,あく,ゴースト
メガヤミラミ,50,85,125,85,115,20,480,あく,ゴースト
クチート,50,85,85,55,55,50,380,はがね,フェアリー
メガクチート,50,105,125,55,95,50,480,はがね,フェアリー
ココドラ,50,70,100,40,40,30,330,はがね,いわ
コドラ,60,90,140,50,50,40,430,はがね,いわ
ボスゴドラ,70,110,180,60,60,50,530,はがね,いわ
メガボスゴドラ,70,140,230,60,80,50,630,はがね,
アサナン,30,40,55,40,55,60,280,かくとう,エスパー
チャーレム,60,60,75,60,75,80,410,かくとう,エスパー
メガチャーレム,60,100,85,80,85,100,510,かくとう,エスパー
ラクライ,40,45,40,65,40,65,295,でんき,
ライボルト,70,75,60,105,60,105,475,でんき,
メガライボルト,70,75,80,135,80,135,575,でんき,
プラスル,60,50,40,85,75,95,405,でんき,
マイナン,60,40,50,75,85,95,405,でんき,
バルビート,65,73,75,47,85,85,430,むし,
イルミーゼ,65,47,75,73,85,85,430,むし,
ロゼリア,50,60,45,100,80,65,400,くさ,どく
ゴクリン,70,43,53,43,53,40,302,どく,
マルノーム,100,73,83,73,83,55,467,どく,
キバニア,45,90,20,65,20,65,305,みず,あく
サメハダー,70,120,40,95,40,95,460,みず,あく
メガサメハダー,70,140,70,110,65,105,560,みず,あく
ホエルコ,130,70,35,70,35,60,400,みず,
ホエルオー,170,90,45,90,45,60,500,みず,
ドンメル,60,60,40,65,45,35,305,ほのお,じめん
バクーダ,70,100,70,105,75,40,460,ほのお,じめん
メガバクーダ,70,120,100,145,105,20,560,ほのお,じめん
コータス,70,85,140,85,70,20,470,ほのお,
バネブー,60,25,35,70,80,60,330,エスパー,
ブーピッグ,80,45,65,90,110,80,470,エスパー,
パッチール,60,60,60,60,60,60,360,ノーマル,
ナックラー,45,100,45,45,45,10,290,じめん,
ビブラーバ,50,70,50,50,50,70,340,じめん,ドラゴン
フライゴン,80,100,80,80,80,100,520,じめん,ドラゴン
サボネア,50,85,40,85,40,35,335,くさ,
ノクタス,70,115,60,115,60,55,475,くさ,あく
チルット,45,40,60,40,75,50,310,ノーマル,ひこう
チルタリス,75,70,90,70,105,80,490,ドラゴン,ひこう
メガチルタリス,75,110,110,110,105,80,590,ドラゴン,フェアリー
ザングース,73,115,60,60,60,90,458,ノーマル,
ハブネーク,73,100,60,100,60,65,458,どく,
ルナトーン,90,55,65,95,85,70,460,いわ,エスパー
ソルロック,90,95,85,55,65,70,460,いわ,エスパー
ドジョッチ,50,48,43,46,41,60,288,みず,じめん
ナマズン,110,78,73,76,71,60,468,みず,じめん
ヘイガニ,43,80,65,50,35,35,308,みず,
シザリガー,63,120,85,90,55,55,468,みず,あく
ヤジロン,40,40,55,40,70,55,300,じめん,エスパー
ネンドール,60,70,105,70,120,75,500,じめん,エスパー
リリーラ,66,41,77,61,87,23,355,いわ,くさ
ユレイドル,86,81,97,81,107,43,495,いわ,くさ
アノプス,45,95,50,40,50,75,355,いわ,むし
アーマルド,75,125,100,70,80,45,495,いわ,むし
ヒンバス,20,15,20,10,55,80,200,みず,
ミロカロス,95,60,79,100,125,81,540,みず,
ポワルン,70,70,70,70,70,70,420,ノーマル,
カクレオン,60,90,70,60,120,40,440,ノーマル,
カゲボウズ,44,75,35,63,33,45,295,ゴースト,
ジュペッタ,64,115,65,83,63,65,455,ゴースト,
メガジュペッタ,64,165,75,93,83,75,555,ゴースト,
ヨマワル,20,40,90,30,90,25,295,ゴースト,
サマヨール,40,70,130,60,130,25,455,ゴースト,
トロピウス,99,68,83,72,87,51,460,くさ,ひこう
チリーン,75,50,80,95,90,65,455,エスパー,
アブソル,65,130,60,75,60,75,465,あく,
メガアブソル,65,150,60,115,60,115,565,あく,
ソーナノ,95,23,48,23,48,23,260,エスパー,
ユキワラシ,50,50,50,50,50,50,300,こおり,
オニゴーリ,80,80,80,80,80,80,480,こおり,
メガオニゴーリ,80,120,80,120,80,100,580,こおり,
タマザラシ,70,40,50,55,50,25,290,こおり,みず
トドグラー,90,60,70,75,70,45,410,こおり,みず
トドゼルガ,110,80,90,95,90,65,530,こおり,みず
パールル,35,64,85,74,55,32,345,みず,
ハンテール,55,104,105,94,75,52,485,みず,
サクラビス,55,84,105,114,75,52,485,みず,
ジーランス,100,90,130,45,65,55,485,みず,いわ
ラブカス,43,30,55,40,65,97,330,みず,
タツベイ,45,75,60,40,30,50,300,ドラゴン,
コモルー,65,95,100,60,50,50,420,ドラゴン,
ボーマンダ,95,135,80,110,80,100,600,ドラゴン,ひこう
メガボーマンダ,95,145,130,120,90,120,700,ドラゴン,ひこう
ダンバル,40,55,80,35,60,30,300,はがね,エスパー
メタング,60,75,100,55,80,50,420,はがね,エスパー
メタグロス,80,135,130,95,90,70,600,はがね,エスパー
メガメタグロス,80,145,150,105,110,110,700,はがね,エスパー
レジロック,80,100,200,50,100,50,580,いわ,
レジアイス,80,50,100,100,200,50,580,こおり,
レジスチル,80,75,150,75,150,50,580,はがね,
ラティアス,80,80,90,110,130,110,600,ドラゴン,エスパー
メガラティアス,80,100,120,140,150,110,700,ドラゴン,エスパー
ラティオス,80,90,80,130,110,110,600,ドラゴン,エスパー
メガラティオス,80,130,100,160,120,110,700,ドラゴン,エスパー
カイオーガ,100,100,90,150,140,90,670,みず,
ゲンシカイオーガ,100,150,90,180,160,90,770,みず,
グラードン,100,150,140,100,90,90,670,じめん,
ゲンシグラードン,100,180,160,150,90,90,770,じめん,ほのお
レックウザ,105,150,90,150,90,95,680,ドラゴン,ひこう
メガレックウザ,105,180,100,180,100,115,780,ドラゴン,ひこう
ジラーチ,100,100,100,100,100,100,600,はがね,エスパー
デオキシスN,50,150,50,150,50,150,600,エスパー,
デオキシスA,50,180,20,180,20,150,600,エスパー,
デオキシスD,50,70,160,70,160,90,600,エスパー,
デオキシスS,50,95,90,95,90,180,600,エスパー,
ナエトル,55,68,64,45,55,31,318,くさ,
ハヤシガメ,75,89,85,55,65,36,405,くさ,
ドダイトス,95,109,105,75,85,56,525,くさ,じめん
ヒコザル,44,58,44,58,44,61,309,ほのお,
モウカザル,64,78,52,78,52,81,405,ほのお,かくとう
ゴウカザル,76,104,71,104,71,108,534,ほのお,かくとう
ポッチャマ,53,51,53,61,56,40,314,みず,
ポッタイシ,64,66,68,81,76,50,405,みず,
エンペルト,84,86,88,111,101,60,530,みず,はがね
ムックル,40,55,30,30,30,60,245,ノーマル,ひこう
ムクバード,55,75,50,40,40,80,340,ノーマル,ひこう
ムクホーク,85,120,70,50,60,100,485,ノーマル,ひこう
ビッパ,59,45,40,35,40,31,250,ノーマル,
ビーダル,79,85,60,55,60,71,410,ノーマル,みず
コロボーシ,37,25,41,25,41,25,194,むし,
コロトック,77,85,51,55,51,65,384,むし,
コリンク,45,65,34,40,34,45,263,でんき,
ルクシオ,60,85,49,60,49,60,363,でんき,
レントラー,80,120,79,95,79,70,523,でんき,
スボミー,40,30,35,50,70,55,280,くさ,どく
ロズレイド,60,70,65,125,105,90,515,くさ,どく
ズガイドス,67,125,40,30,30,58,350,いわ,
ラムパルド,97,165,60,65,50,58,495,いわ,
タテトプス,30,42,118,42,88,30,350,いわ,はがね
トリデプス,60,52,168,47,138,30,495,いわ,はがね
ミノムッチ,40,29,45,29,45,36,224,むし,
ミノマダム草,60,59,85,79,105,36,424,むし,くさ
ミノマダム地,60,79,105,59,85,36,424,むし,じめん
ミノマダム鋼,60,69,95,69,95,36,424,むし,はがね
ガーメイル,70,94,50,94,50,66,424,むし,ひこう
ミツハニー,30,30,42,30,42,70,244,むし,ひこう
ビークイン,70,80,102,80,102,40,474,むし,ひこう
パチリス,60,45,70,45,90,95,405,でんき,
ブイゼル,55,65,35,60,30,85,330,みず,
フローゼル,85,105,55,85,50,115,495,みず,
チェリンボ,45,35,45,62,53,35,275,くさ,
チェリム,70,60,70,87,78,85,450,くさ,
カラナクシ,76,48,48,57,62,34,325,みず,
トリトドン,111,83,68,92,82,39,475,みず,じめん
エテボース,75,100,66,60,66,115,482,ノーマル,
フワンテ,90,50,34,60,44,70,348,ゴースト,ひこう
フワライド,150,80,44,90,54,80,498,ゴースト,ひこう
ミミロル,55,66,44,44,56,85,350,ノーマル,
ミミロップ,65,76,84,54,96,105,480,ノーマル,
メガミミロップ,65,136,94,54,96,135,580,ノーマル,かくとう
ムウマージ,60,60,60,105,105,105,495,ゴースト,
ドンカラス,100,125,52,105,52,71,505,あく,ひこう
ニャルマー,49,55,42,42,37,85,310,ノーマル,
ブニャット,71,82,64,64,59,112,452,ノーマル,
リーシャン,45,30,50,65,50,45,285,エスパー,
スカンプー,63,63,47,41,41,74,329,どく,あく
スカタンク,103,93,67,71,61,84,479,どく,あく
ドーミラー,57,24,86,24,86,23,300,はがね,エスパー
ドータクン,67,89,116,79,116,33,500,はがね,エスパー
ウソハチ,50,80,95,10,45,10,290,いわ,
マネネ,20,25,45,70,90,60,310,エスパー,フェアリー
ピンプク,100,5,5,15,65,30,220,ノーマル,
ペラップ,76,65,45,92,42,91,411,ノーマル,ひこう
ミカルゲ,50,92,108,92,108,35,485,ゴースト,あく
フカマル,58,70,45,40,45,42,300,ドラゴン,じめん
ガバイト,68,90,65,50,55,82,410,ドラゴン,じめん
ガブリアス,108,130,95,80,85,102,600,ドラゴン,じめん
メガガブリアス,108,170,115,120,95,92,700,ドラゴン,じめん
ゴンベ,135,85,40,40,85,5,390,ノーマル,
リオル,40,70,40,35,40,60,285,かくとう,
ルカリオ,70,110,70,115,70,90,525,かくとう,はがね
メガルカリオ,70,145,88,140,70,112,625,かくとう,はがね
ヒポポタス,68,72,78,38,42,32,330,じめん,
カバルドン,108,112,118,68,72,47,525,じめん,
スコルピ,40,50,90,30,55,65,330,どく,むし
ドラピオン,70,90,110,60,75,95,500,どく,あく
グレッグル,48,61,40,61,40,50,300,どく,かくとう
ドクロッグ,83,106,65,86,65,85,490,どく,かくとう
マスキッパ,74,100,72,90,72,46,454,くさ,
ケイコウオ,49,49,56,49,61,66,330,みず,
ネオラント,69,69,76,69,86,91,460,みず,
タマンタ,45,20,50,60,120,50,345,みず,ひこう
ユキカブリ,60,62,50,62,60,40,334,くさ,こおり
ユキノオー,90,92,75,92,85,60,494,くさ,こおり
メガユキノオー,90,132,105,132,105,30,594,くさ,こおり
マニューラ,70,120,65,45,85,125,510,あく,こおり
ジバコイル,70,70,115,130,90,60,535,でんき,はがね
ベロベルト,110,85,95,80,95,50,515,ノーマル,
ドサイドン,115,140,130,55,55,40,535,じめん,いわ
モジャンボ,100,100,125,110,50,50,535,くさ,
エレキブル,75,123,67,95,85,95,540,でんき,
ブーバーン,75,95,67,125,95,83,540,ほのお,
トゲキッス,85,50,95,120,115,80,545,フェアリー,ひこう
メガヤンマ,86,76,86,116,56,95,515,むし,ひこう
リーフィア,65,110,130,60,65,95,525,くさ,
グレイシア,65,60,110,130,95,65,525,こおり,
グライオン,75,95,125,45,75,95,510,じめん,ひこう
マンムー,110,130,80,70,60,80,530,こおり,じめん
ポリゴンＺ,85,80,70,135,75,90,535,ノーマル,
エルレイド,68,125,65,65,115,80,518,エスパー,かくとう
メガエルレイド,68,165,95,65,115,110,618,エスパー,かくとう
ダイノーズ,60,55,145,75,150,40,525,いわ,はがね
ヨノワール,45,100,135,65,135,45,525,ゴースト,
ユキメノコ,70,80,70,80,70,110,480,こおり,ゴースト
ロトム,50,50,77,95,77,91,440,でんき,ゴースト
ロトム（ヒート）,50,65,107,105,107,86,520,でんき,ほのお
ロトム（ウォッシュ）,50,65,107,105,107,86,520,でんき,みず
ロトム（フロスト）,50,65,107,105,107,86,520,でんき,こおり
ロトム（スピン）,50,65,107,105,107,86,520,でんき,ひこう
ロトム（カット）,50,65,107,105,107,86,520,でんき,くさ
ユクシー,75,75,130,75,130,95,580,エスパー,
エムリット,80,105,105,105,105,80,580,エスパー,
アグノム,75,125,70,125,70,115,580,エスパー,
ディアルガ,100,120,120,150,100,90,680,はがね,ドラゴン
パルキア,90,120,100,150,120,100,680,みず,ドラゴン
ヒードラン,91,90,106,130,106,77,600,ほのお,はがね
レジギガス,110,160,110,80,110,100,670,ノーマル,
ギラティナA,150,100,120,100,120,90,680,ゴースト,ドラゴン
ギラティナO,150,120,100,120,100,90,680,ゴースト,ドラゴン
クレセリア,120,70,120,75,130,85,600,エスパー,
フィオネ,80,80,80,80,80,80,480,みず,
マナフィ,100,100,100,100,100,100,600,みず,
ダークライ,70,90,90,135,90,125,600,あく,
シェイミL,100,100,100,100,100,100,600,くさ,
シェイミS,100,103,75,120,75,127,600,くさ,ひこう
アルセウス,120,120,120,120,120,120,720,ノーマル,
ビクティニ,100,100,100,100,100,100,600,エスパー,ほのお
ツタージャ,45,45,55,45,55,63,308,くさ,
ジャノビー,60,60,75,60,75,83,413,くさ,
ジャローダ,75,75,95,75,95,113,528,くさ,
ポカブ,65,63,45,45,45,45,308,ほのお,
チャオブー,90,93,55,70,55,55,418,ほのお,かくとう
エンブオー,110,123,65,100,65,65,528,ほのお,かくとう
ミジュマル,55,55,45,63,45,45,308,みず,
フタチマル,75,75,60,83,60,60,413,みず,
ダイケンキ,95,100,85,108,70,70,528,みず,
ミネズミ,45,55,39,35,39,42,255,ノーマル,
ミルホッグ,60,85,69,60,69,77,420,ノーマル,
ヨーテリー,45,60,45,25,45,55,275,ノーマル,
ハーデリア,65,80,65,35,65,60,370,ノーマル,
ムーランド,85,110,90,45,90,80,500,ノーマル,
チョロネコ,41,50,37,50,37,66,281,あく,
レパルダス,64,88,50,88,50,106,446,あく,
ヤナップ,50,53,48,53,48,64,316,くさ,
ヤナッキー,75,98,63,98,63,101,498,くさ,
バオップ,50,53,48,53,48,64,316,ほのお,
バオッキー,75,98,63,98,63,101,498,ほのお,
ヒヤップ,50,53,48,53,48,64,316,みず,
ヒヤッキー,75,98,63,98,63,101,498,みず,
ムンナ,76,25,45,67,55,24,292,エスパー,
ムシャーナ,116,55,85,107,95,29,487,エスパー,
マメパト,50,55,50,36,30,43,264,ノーマル,ひこう
ハトーボー,62,77,62,50,42,65,358,ノーマル,ひこう
ケンホロウ,80,115,80,65,55,93,488,ノーマル,ひこう
シママ,45,60,32,50,32,76,295,でんき,
ゼブライカ,75,100,63,80,63,116,497,でんき,
ダンゴロ,55,75,85,25,25,15,280,いわ,
ガントル,70,105,105,50,40,20,390,いわ,
ギガイアス,85,135,130,60,80,25,515,いわ,
コロモリ,65,45,43,55,43,72,323,エスパー,ひこう
ココロモリ,67,57,55,77,55,114,425,エスパー,ひこう
モグリュー,60,85,40,30,45,68,328,じめん,
ドリュウズ,110,135,60,50,65,88,508,じめん,はがね
タブンネ,103,60,86,60,86,50,445,ノーマル,
メガタブンネ,103,60,126,80,126,50,545,ノーマル,フェアリー
ドッコラー,75,80,55,25,35,35,305,かくとう,
ドテッコツ,85,105,85,40,50,40,405,かくとう,
ローブシン,105,140,95,55,65,45,505,かくとう,
オタマロ,50,50,40,50,40,64,294,みず,
ガマガル,75,65,55,65,55,69,384,みず,じめん
ガマゲロゲ,105,95,75,85,75,74,509,みず,じめん
ナゲキ,120,100,85,30,85,45,465,かくとう,
ダゲキ,75,125,75,30,75,85,465,かくとう,
クルミル,45,53,70,40,60,42,310,むし,くさ
クルマユ,55,63,90,50,80,42,380,むし,くさ
ハハコモリ,75,103,80,70,80,92,500,むし,くさ
フシデ,30,45,59,30,39,57,260,むし,どく
ホイーガ,40,55,99,40,79,47,360,むし,どく
ペンドラー,60,100,89,55,69,112,485,むし,どく
モンメン,40,27,60,37,50,66,280,くさ,フェアリー
エルフーン,60,67,85,77,75,116,480,くさ,フェアリー
チュリネ,45,35,50,70,50,30,280,くさ,
ドレディア,70,60,75,110,75,90,480,くさ,
バスラオ赤,70,92,65,80,55,98,460,みず,
バスラオ青,70,92,65,80,55,98,460,みず,
メグロコ,50,72,35,35,35,65,292,じめん,あく
ワルビル,60,82,45,45,45,74,351,じめん,あく
ワルビアル,95,117,80,65,70,92,519,じめん,あく
ダルマッカ,70,90,45,15,45,50,315,ほのお,
ヒヒダルマN,105,140,55,30,55,95,480,ほのお,
ヒヒダルマD,105,30,105,140,105,55,540,ほのお,エスパー
マラカッチ,75,86,67,106,67,60,461,くさ,
イシズマイ,50,65,85,35,35,55,325,むし,いわ
イワパレス,70,105,125,65,75,45,485,むし,いわ
ズルッグ,50,75,70,35,70,48,348,あく,かくとう
ズルズキン,65,90,115,45,115,58,488,あく,かくとう
シンボラー,72,58,80,103,80,97,490,エスパー,ひこう
デスマス,38,30,85,55,65,30,303,ゴースト,
デスカーン,58,50,145,95,105,30,483,ゴースト,
プロトーガ,54,78,103,53,45,22,355,みず,いわ
アバゴーラ,74,108,133,83,65,32,495,みず,いわ
アーケン,55,112,45,74,45,70,401,いわ,ひこう
アーケオス,75,140,65,112,65,110,567,いわ,ひこう
ヤブクロン,50,50,62,40,62,65,329,どく,
ダストダス,80,95,82,60,82,75,474,どく,
ゾロア,40,65,40,80,40,65,330,あく,
ゾロアーク,60,105,60,120,60,105,510,あく,
チラーミィ,55,50,40,40,40,75,300,ノーマル,
チラチーノ,75,95,60,65,60,115,470,ノーマル,
ゴチム,45,30,50,55,65,45,290,エスパー,
ゴチミル,60,45,70,75,85,55,390,エスパー,
ゴチルゼル,70,55,95,95,110,65,490,エスパー,
ユニラン,45,30,40,105,50,20,290,エスパー,
ダブラン,65,40,50,125,60,30,370,エスパー,
ランクルス,110,65,75,125,85,30,490,エスパー,
コアルヒー,62,44,50,44,50,55,305,みず,ひこう
スワンナ,75,87,63,87,63,98,473,みず,ひこう
バニプッチ,36,50,50,65,60,44,305,こおり,
バニリッチ,51,65,65,80,75,59,395,こおり,
バイバニラ,71,95,85,110,95,79,535,こおり,
シキジカ,60,60,50,40,50,75,335,ノーマル,むし
メブキジカ,80,100,70,60,70,95,475,ノーマル,むし
エモンガ,55,75,60,75,60,103,428,でんき,ひこう
カブルモ,50,75,45,40,45,60,315,むし,
シュバルゴ,70,135,105,60,105,20,495,むし,はがね
タマゲタケ,69,55,45,55,55,15,294,くさ,どく
モロバレル,114,85,70,85,80,30,464,くさ,どく
プルリル,55,40,50,65,85,40,335,みず,ゴースト
ブルンゲル,100,60,70,85,105,60,480,みず,ゴースト
ママンボウ,165,75,80,40,45,65,470,みず,
バチュル,50,47,50,57,50,65,319,むし,でんき
デンチュラ,70,77,60,97,60,108,472,むし,でんき
テッシード,44,50,91,24,86,10,305,くさ,はがね
ナットレイ,74,94,131,54,116,20,489,くさ,はがね
ギアル,40,55,70,45,60,30,300,はがね,
ギギアル,60,80,95,70,85,50,440,はがね,
ギギギアル,60,100,115,70,85,90,520,はがね,
シビシラス,35,55,40,45,40,60,275,でんき,
シビビール,65,85,70,75,70,40,405,でんき,
シビルドン,85,115,80,105,80,50,515,でんき,
リグレー,55,55,55,85,55,30,335,エスパー,
オーベム,75,75,75,125,95,40,485,エスパー,
ヒトモシ,50,30,55,65,55,20,275,ゴースト,ほのお
ランプラー,60,40,60,95,60,55,370,ゴースト,ほのお
シャンデラ,60,55,90,145,90,80,520,ゴースト,ほのお
キバゴ,46,87,60,30,40,57,320,ドラゴン,
オノンド,66,117,70,40,50,67,410,ドラゴン,
オノノクス,76,147,90,60,70,97,540,ドラゴン,
クマシュン,55,70,40,60,40,40,305,こおり,
ツンベアー,95,130,80,70,80,50,505,こおり,
フリージオ,80,50,50,95,135,105,515,こおり,
チョボマキ,50,40,85,40,65,25,305,むし,
アギルダー,80,70,40,100,60,145,495,むし,
マッギョ,109,66,84,81,99,32,471,じめん,でんき
コジョフー,45,85,50,55,50,65,350,かくとう,
コジョンド,65,125,60,95,60,105,510,かくとう,
クリムガン,77,120,90,60,90,48,485,ドラゴン,
ゴビット,59,74,50,35,50,35,303,じめん,ゴースト
ゴルーグ,89,124,80,55,80,55,483,じめん,ゴースト
コマタナ,45,85,70,40,40,60,340,あく,はがね
キリキザン,65,125,100,60,70,70,490,あく,はがね
バッフロン,95,110,95,40,95,55,490,ノーマル,
ワシボン,70,83,50,37,50,60,350,ノーマル,ひこう
ウォーグル,100,123,75,57,75,80,510,ノーマル,ひこう
バルチャイ,70,55,75,45,65,60,370,あく,ひこう
バルジーナ,110,65,105,55,95,80,510,あく,ひこう
クイタラン,85,97,66,105,66,65,484,ほのお,
アイアント,58,109,112,48,48,109,484,むし,はがね
モノズ,52,65,50,45,50,38,300,あく,ドラゴン
ジヘッド,72,85,70,65,70,58,420,あく,ドラゴン
サザンドラ,92,105,90,125,90,98,600,あく,ドラゴン
メラルバ,55,85,55,50,55,60,360,むし,ほのお
ウルガモス,85,60,65,135,105,100,550,むし,ほのお
コバルオン,91,90,129,90,72,108,580,はがね,かくとう
テラキオン,91,129,90,72,90,108,580,いわ,かくとう
ビリジオン,91,90,72,90,129,108,580,くさ,かくとう
トルネロス化身,79,115,70,125,80,111,580,ひこう,
トルネロス霊獣,79,100,80,110,90,121,580,ひこう,
ボルトロス化身,79,115,70,125,80,111,580,でんき,ひこう
ボルトロス霊獣,79,105,70,145,80,101,580,でんき,ひこう
レシラム,100,120,100,150,120,90,680,ドラゴン,ほのお
ゼクロム,100,150,120,120,100,90,680,ドラゴン,でんき
ランドロス化身,89,125,90,115,80,101,600,じめん,ひこう
ランドロス霊獣,89,145,90,105,80,91,600,じめん,ひこう
キュレム,125,130,90,130,90,95,660,ドラゴン,こおり
ブラックキュレム,125,170,100,120,90,95,700,ドラゴン,こおり
ホワイトキュレム,125,120,90,170,100,95,700,ドラゴン,こおり
ケルディオ,91,72,90,129,90,108,580,みず,かくとう
ケルディオ覚悟,91,72,90,129,90,108,580,みず,かくとう
メロエッタＶ,100,77,77,128,128,90,600,ノーマル,エスパー
メロエッタＳ,100,128,90,77,77,128,600,ノーマル,かくとう
ゲノセクト,71,120,95,120,95,99,600,むし,はがね
ハリマロン,56,61,65,48,45,38,313,くさ,
ハリボーグ,61,78,95,56,58,57,405,くさ,
ブリガロン,88,107,122,74,75,64,530,くさ,かくとう
フォッコ,40,45,40,62,60,60,307,ほのお,
テールナー,59,59,58,90,70,73,409,ほのお,
マフォクシー,75,69,72,114,100,104,534,ほのお,エスパー
ケロマツ,41,56,40,62,44,71,314,みず,
ゲコガシラ,54,63,52,83,56,97,405,みず,
ゲッコウガ,72,95,67,103,71,122,530,みず,あく
ホルビー,38,36,38,32,36,57,237,ノーマル,
ホルード,85,56,77,50,77,78,423,ノーマル,じめん
ヤヤコマ,45,50,43,40,38,62,278,ノーマル,ひこう
ヒノヤコマ,62,73,55,56,52,84,382,ほのお,ひこう
ファイアロー,78,81,71,74,69,126,499,ほのお,ひこう
コフキムシ,38,35,40,27,25,35,200,むし,
コフーライ,45,22,60,27,30,29,213,むし,
ビビヨン,80,52,50,90,50,89,411,むし,ひこう
シシコ,62,50,58,73,54,72,369,ほのお,ノーマル
カエンジシ,86,68,72,109,66,106,507,ほのお,ノーマル
フラベベ,44,38,39,61,79,42,303,フェアリー,
フラエッテ,54,45,47,75,98,52,371,フェアリー,
フラエッテＡＺ,74,65,67,125,128,92,551,フェアリー,
フラージェス,78,65,68,112,154,75,552,フェアリー,
メェークル,66,65,48,62,57,52,350,くさ,
ゴーゴート,123,100,62,97,81,68,531,くさ,
ヤンチャム,67,82,62,46,48,43,348,かくとう,
ゴロンダ,95,124,78,69,71,58,495,かくとう,あく
トリミアン,75,80,60,65,90,102,472,ノーマル,
ニャスパー,62,48,54,63,60,68,355,エスパー,
ニャオニクス（オス）,74,48,76,83,81,104,466,エスパー,
ニャオニクス（メス）,74,48,76,83,81,104,466,エスパー,
ヒトツキ,45,80,100,35,37,28,325,はがね,ゴースト
ニダンギル,59,110,150,45,49,35,448,はがね,ゴースト
ギルガルド（シールド）,60,50,140,50,140,60,500,はがね,ゴースト
ギルガルド（ソード）,60,140,50,140,50,60,520,はがね,ゴースト
シュシュプ,78,52,60,63,65,23,341,フェアリー,
フレフワン,101,72,72,99,89,29,462,フェアリー,
ペロッパフ,62,48,66,59,57,49,341,フェアリー,
ペロリーム,82,80,86,85,75,72,480,フェアリー,
マーイーカ,53,54,53,37,46,45,288,あく,エスパー
カラマネロ,86,92,88,68,75,73,482,あく,エスパー
カメテテ,42,52,67,39,56,50,306,いわ,みず
ガメノデス,72,105,115,54,86,68,500,いわ,みず
クズモー,50,60,60,60,60,30,320,どく,みず
ドラミドロ,65,75,90,97,123,44,494,どく,ドラゴン
ウデッポウ,50,53,62,58,63,44,330,みず,
ブロスター,71,73,88,120,89,59,500,みず,
エリキテル,44,38,33,61,43,70,289,でんき,ノーマル
エレザード,62,55,52,109,94,109,481,でんき,ノーマル
チゴラス,58,89,77,45,45,48,362,いわ,ドラゴン
ガチゴラス,82,121,119,69,59,71,521,いわ,ドラゴン
アマルス,77,59,50,67,63,46,362,いわ,こおり
アマルルガ,123,77,72,99,92,58,521,いわ,こおり
ニンフィア,95,65,65,110,130,60,525,フェアリー,
ルチャブル,78,92,75,74,63,118,500,かくとう,ひこう
デデンネ,67,58,57,81,67,101,431,でんき,フェアリー
メレシー,50,50,150,50,150,50,500,いわ,フェアリー
ヌメラ,45,50,35,55,75,40,300,ドラゴン,
ヌメイル,68,75,53,83,113,60,452,ドラゴン,
ヌメルゴン,90,100,70,110,150,80,600,ドラゴン,
クレッフィ,57,80,91,80,87,75,470,はがね,フェアリー
ボクレー,43,70,48,50,60,38,309,ゴースト,くさ
オーロット,85,110,76,65,82,56,474,ゴースト,くさ
バケッチャ,49,66,70,44,55,51,335,ゴースト,くさ
バケッチャ小,44,66,70,44,55,56,335,ゴースト,くさ
バケッチャ大,54,66,70,44,55,46,335,ゴースト,くさ
バケッチャ特大,59,66,70,44,55,41,335,ゴースト,くさ
パンプジン,65,90,122,58,75,84,494,ゴースト,くさ
パンプジン小,55,85,122,58,75,99,494,ゴースト,くさ
パンプジン大,75,95,122,58,75,69,494,ゴースト,くさ
パンプジン特大,85,100,122,58,75,54,494,ゴースト,くさ
カチコール,55,69,85,32,35,28,304,こおり,
クレベース,95,117,184,44,46,28,514,こおり,
オンバット,40,30,35,45,40,55,245,ひこう,ドラゴン
オンバーン,85,70,80,97,80,123,535,ひこう,ドラゴン
ゼルネアス,126,131,95,131,98,99,680,フェアリー,
イベルタル,126,131,95,131,98,99,680,あく,ひこう
ジガルデ10%,100,71,61,85,115,486,,ドラゴン,じめん
ジガルデ50%,100,121,81,95,95,600,,ドラゴン,じめん
ジガルデ完全,216,100,121,91,95,85,708,ドラゴン,じめん
ディアンシー,50,100,150,100,150,50,600,いわ,フェアリー
メガディアンシー,50,160,110,160,110,110,700,いわ,フェアリー
フーパ（戒め）,80,110,60,150,130,70,600,エスパー,ゴースト
フーパ（解放）,80,160,60,170,130,80,680,エスパー,あく
ボルケニオン,80,110,120,130,90,70,600,ほのお,みず
モクロー,68,55,55,50,50,42,320,くさ,ひこう
フクスロー,78,75,75,70,70,52,420,くさ,ひこう
ジュナイパー,78,107,75,100,100,70,530,くさ,ゴースト
ニャビー,45,65,40,60,40,70,320,ほのお,
ニャヒート,65,85,50,80,50,90,420,ほのお,
ガオガエン,95,115,90,80,90,60,530,ほのお,あく
アシマリ,50,54,54,66,56,40,320,みず,
オシャマリ,60,69,69,91,81,50,420,みず,
アシレーヌ,80,74,74,126,116,60,530,みず,フェアリー
ツツケラ,35,75,30,30,30,65,265,ノーマル,ひこう
ケララッパ,55,85,50,40,50,75,355,ノーマル,ひこう
ドデカバシ,80,120,75,75,75,60,485,ノーマル,ひこう
ヤングース,48,70,30,30,30,45,253,ノーマル,
デカグース,88,110,60,55,60,45,418,ノーマル,
アゴジムシ,47,62,45,55,45,46,300,むし,
デンヂムシ,57,82,95,55,75,36,400,むし,でんき
クワガノン,77,70,90,145,75,43,500,むし,でんき
マケンカニ,47,82,57,42,47,63,338,かくとう,
ケケンカニ,97,132,77,62,67,43,478,かくとう,こおり
オドリドリ（めらめら）,75,70,70,98,70,93,476,ほのお,ひこう
オドリドリ（ぱちぱち）,75,70,70,98,70,93,476,でんき,ひこう
オドリドリ（ふらふら）,75,70,70,98,70,93,476,エスパー,ひこう
オドリドリ（まいまい）,75,70,70,98,70,93,476,ゴースト,ひこう
アブリー,40,45,40,55,40,84,304,むし,フェアリー
アブリボン,60,55,60,95,70,124,464,むし,フェアリー
イワンコ,45,65,40,30,40,60,280,いわ,
ルガルガン昼,75,115,65,55,65,112,487,いわ,
ルガルガン夜,85,115,75,55,75,82,487,いわ,
ヨワシ,45,20,20,25,25,40,175,みず,
ヨワシ（群れ）,45,140,130,140,135,30,620,みず,
ヒドイデ,50,53,62,43,52,45,305,どく,みず
ドヒドイデ,50,63,152,53,142,35,495,どく,みず
ドロバンコ,70,100,70,45,55,45,385,じめん,
バンバドロ,100,125,100,55,85,35,500,じめん,
シズクモ,38,40,52,40,72,27,269,みず,むし
オニシズクモ,68,70,92,50,132,42,454,みず,むし
カリキリ,40,55,35,50,35,35,250,くさ,
ラランテス,70,105,90,80,90,45,480,くさ,
ネマシュ,40,35,55,65,75,15,285,くさ,フェアリー
マシェード,60,45,80,90,100,30,405,くさ,フェアリー
ヤトウモリ,48,44,40,71,40,77,320,どく,ほのお
エンニュート,68,64,60,111,60,117,480,どく,ほのお
ヌイコグマ,70,75,50,45,50,50,340,ノーマル,かくとう
キテルグマ,120,125,80,55,60,60,500,ノーマル,かくとう
アマカジ,42,30,38,30,38,32,210,くさ,
アママイコ,52,40,48,40,48,62,290,くさ,
アマージョ,72,120,98,50,98,72,510,くさ,
キュワワー,51,52,90,82,110,100,485,フェアリー,
ヤレユータン,90,60,80,90,110,60,490,ノーマル,エスパー
ナゲツケサル,100,120,90,40,60,80,490,かくとう,
コソクムシ,25,35,40,20,30,80,230,むし,みず
グソクムシャ,75,125,140,60,90,40,530,むし,みず
スナバァ,55,55,80,70,45,15,320,ゴースト,じめん
シロデスナ,85,75,110,100,75,35,480,ゴースト,じめん
ナマコブシ,55,60,130,30,130,5,410,みず,
タイプ：ヌル,95,95,95,95,95,59,534,ノーマル,
シルヴァディ,95,95,95,95,95,95,570,ノーマル,
メテノ（流星）,60,60,100,60,100,60,440,いわ,ひこう
メテノ（コア）,60,100,60,100,60,120,500,いわ,ひこう
ネッコアラ,65,115,65,75,95,65,480,ノーマル,
バクガメス,60,78,135,91,85,36,485,ほのお,ドラゴン
トゲデマル,65,98,63,40,73,96,435,でんき,はがね
ミミッキュ,55,90,80,50,105,96,476,ゴースト,フェアリー
ハギギシリ,68,105,70,70,70,92,475,みず,エスパー
ジジーロン,78,60,85,135,91,36,485,ノーマル,ドラゴン
ダダリン,70,131,100,86,90,40,517,ゴースト,くさ
ジャラコ,45,55,65,45,45,45,300,ドラゴン,
ジャランゴ,55,75,90,65,70,65,420,ドラゴン,かくとう
ジャラランガ,75,110,125,100,105,85,600,ドラゴン,かくとう
カプ・コケコ,70,115,85,95,75,130,570,でんき,フェアリー
カプ・テテフ,70,85,75,130,115,95,570,エスパー,フェアリー
カプ・ブルル,70,130,115,85,95,75,570,くさ,フェアリー
カプ・レヒレ,70,75,115,95,130,85,570,みず,フェアリー
コスモッグ,43,29,31,29,31,37,200,エスパー,
コスモウム,43,29,131,29,131,37,400,エスパー,
ソルガレオ,137,137,107,113,89,97,680,エスパー,はがね
ルナアーラ,137,113,89,137,107,97,680,エスパー,ゴースト
ウツロイド,109,53,47,127,131,103,570,いわ,どく
マッシブーン,107,139,139,53,53,79,570,むし,かくとう
フェローチェ,71,137,37,137,37,151,570,むし,かくとう
デンジュモク,83,89,71,173,71,83,570,でんき,
テッカグヤ,97,101,103,107,101,61,570,はがね,ひこう
カミツルギ,59,181,131,59,31,109,570,くさ,はがね
アクジキング,223,101,53,97,53,43,570,あく,ドラゴン
ネクロズマ,97,107,101,127,89,79,600,エスパー,
マギアナ,80,95,115,130,115,65,600,はがね,フェアリー
マーシャドー,90,125,80,90,90,125,600,かくとう,ゴースト
サルノリ,50,65,50,40,40,65,310
バチンキー,70,85,70,55,60,80,420
ゴリランダー,100,125,90,60,70,85,530
ヒバニー,50,71,40,40,40,69,310
ラビフット,65,86,60,55,60,94,420
エースバーン,80,116,75,65,75,119,530
メッソン,50,40,40,70,40,70,310
ジメレオン,65,60,55,95,55,90,420
インテレオン,70,85,65,125,65,120,530
サッチムシ,25,20,20,25,45,45,180
レドームシ,50,35,80,50,90,30,335
イオルブ,60,45,110,80,120,90,505
ココガラ,38,47,35,33,35,57,245
アオガラス,68,67,55,43,55,77,365
アーマーガア,98,87,105,53,85,67,495
ホシガリス,70,55,55,35,35,25,275
ヨクバリス,120,95,95,55,75,20,460
クスネ,40,28,28,47,52,50,245
フォクスライ,70,58,58,87,92,90,455
ジグザグマ（ガラル）,38,30,41,30,41,60,240
マッスグマ（ガラル）,78,70,61,50,61,100,420
タチフサグマ,93,90,101,60,81,95,520
ウールー,42,40,55,40,45,48,270
バイウールー,72,80,100,60,90,88,490
カムカメ,50,64,50,38,38,44,284
カジリガメ,90,115,90,48,68,74,485
ワンパチ,59,45,50,40,50,26,270
パルスワン,69,90,60,90,60,121,490
ヒメンカ,40,40,60,40,60,10,250
ワタシラガ,60,50,90,80,120,60,460
ヤクデ,50,65,45,50,50,45,305
マルヤクデ,100,115,65,90,90,65,525
タンドン,30,40,50,40,50,30,240
トロッゴン,80,60,90,60,70,50,410
セキタンザン,110,80,120,80,90,30,510
サシカマス,41,63,40,40,30,66,280
カマスジョー,61,123,60,60,50,136,490
ニャース（ガラル）,50,65,55,40,40,40,290
ニャイキング,70,110,100,50,60,50,440
マホミル,45,40,40,50,61,34,270
マホイップ,65,60,75,110,121,64,495
カジッチュ,40,40,80,40,40,20,260
アップリュー,70,110,80,95,60,70,485
タルップル,110,85,80,100,80,30,485
カモネギ（ガラル）,52,95,55,58,62,55,377
ネギガナイト,62,135,95,68,82,65,507
マッギョ（ガラル）,109,81,99,66,84,32,471
サニーゴ（ガラル）,65,55,100,65,100,30,415
サニゴーン,60,95,50,145,130,30,510
ベロバー,45,45,30,55,40,50,265
ギモー,65,60,45,75,55,70,370
オーロンゲ,95,120,65,95,75,60,510
ミブリム,42,30,45,56,53,39,265
テブリム,57,40,65,86,73,49,370
ブリムオン,57,90,95,136,103,29,510
マタドガス（ガラル）,65,90,120,85,70,60,490
ゾウドウ,72,80,49,40,49,40,330
ダイオウドウ,122,130,69,80,69,30,500
ウッウ,70,85,55,85,95,85,475
エレズン,40,38,35,54,35,40,242
ストリンダー,75,98,70,114,70,75,502
スナヘビ,52,57,75,35,50,46,315
サダイジャ,72,107,125,65,70,71,510
デスマス（ガラル）,38,55,85,30,65,30,303
デスバーン,58,95,145,50,105,30,483
ポニータ（ガラル）,50,85,55,65,65,90,410
ギャロップ（ガラル）,65,100,70,80,80,105,500
ヤバチャ,40,45,45,74,54,50,308
ポットデス,60,65,65,134,114,70,508
イエッサン（オス）,60,65,55,105,95,95,475
イエッサン（メス）,70,55,65,95,105,85,475
モルペコ,58,95,58,70,58,97,436
タイレーツ,65,100,100,70,60,75,470
ユキハミ,30,25,35,45,30,20,185
モスノウ,70,65,60,125,90,65,475
タタッコ,50,68,60,50,50,32,310
オトスパス,80,118,90,70,80,42,480
バリヤード（ガラル）,50,65,65,90,90,100,460
バリコオル,80,85,75,110,100,70,520
ダルマッカ（ガラル）,70,90,45,15,45,50,315
ヒヒダルマ（ガラル）,105,140,55,30,55,95,480
イシヘンジン,100,125,135,20,20,70,470
コオリッポ（アイスフェイス）,75,80,110,65,90,50,470
コオリッポ（ナイスフェイス）,75,80,70,65,50,130,470
ジュラルドン,70,95,115,120,50,85,535
パッチラゴン,90,100,90,80,70,75,505
パッチルドン,90,100,90,90,80,55,505
ウオノラゴン,90,90,100,70,80,75,505
ウオチルドン,90,90,100,80,90,55,505
ドラメシヤ,28,60,30,40,30,82,270
ドロンチ,68,80,50,60,50,102,410
ドラパルト,88,120,75,100,75,142,600
ザシアン,92,130,115,80,115,138,670
ザシアン（けんのおう）,92,170,115,80,115,148,720
ザマゼンタ,92,130,115,80,115,138,670
ザマゼンタ（たてのおう）,92,130,145,80,145,128,720
ムゲンダイナ,140,85,95,145,95,130,690
ムゲンダイナ（ムゲン）,255,115,250,125,250,130,1125
